1111111
1000001
1010111
1010101
1011101
1P00001
1111111