1111111
1A00001
1011101
1000101
1110111
???????
1111111