[
    "1111111",
    "1A10001",
    "1010111",
    "1000001",
    "1011111",
    "1P00001",
    "1111111"
]