[
    "1111111",
    "1A00001",
    "1011111",
    "1010001",
    "1010101",
    "100P101",
    "1111111"
]