[
    "1111111",
    "1A000P1",
    "1110111",
    "1000101",
    "1010101",
    "1010001",
    "1111111"
]