[
    "1111111",
    "1A00001",
    "1010111",
    "1010101",
    "1011101",
    "1P00001",
    "1111111"
]