[
    "1111111",
    "1A00001",
    "1011111",
    "1010101",
    "1010101",
    "1000P01",
    "1111111"
]