1111111
1000001
1011101
1000101
1010111
1A1P001
1111111