1111111
1000001
1110111
1000001
1011101
1010P01
1111111